############################
#M..o....##......##.....o..#
#.####.#.##.####.##.#.####.#
#......#...................#
###.##.###.##.##.###..##.###
###.##.###.##.##.###..##.###
#......##..........##......#
#.####.##.########.##.####.#
#.#....##.########.##.#....#
#.#..#.##          ##.#..#.#
#.#..#.##  ######  ##.#..#.#
#.#..#.##    CIBP  ##.#..#.#
#.#..#.##  ######  ##.#..#.#
#.#..#.##          ##.#..#.#
#.#....##.########.##.#....#
#.#.##.##.########.##.####.#
#......##..........##......#
###.##.##########.##..##.###
###.##................##.###
###.##.###.######.###.##.###
#o.......#........#.......o#
#.######.#.####.#.#.######.#
#......#..........#........#
###.########.##.########.###
#..........................#
#.##########.##.##########.#
#..........................#
#.########################.#
#........o........o........#
############################
