############################
#............##............#
#.####.#####.##.#####.####.#
#o...#.#...#.##.#...#.#...o#
#.##.#.#.#.#.##.#.#.#.#.##.#
#..........................#
#.##.#.##.#.####.#.##.#.##.#
#.##.#.##.#.####.#.##.#.##.#
#......##....##....##......#
#.#.##.##### ## #####.##.#.#
#.#.##.#####    #####.##.#.#
#.#.##....## ## ##....##.#.#
#.#.##.##.##    ##.##.##.#.#
#.#.##.##.##CIBP##.##.##.#.#
#.#.##.##.########.##.##.#.#
#.#.##.##..........##.##.#.#
#.#.##.##.########.##.##.#.#
#.#.##.##.########.##.##.#.#
#............##............#
#..###.#####.##.#####.###..#
#..###.#####.##.#####.###..#
#o..#..................#..o#
#...#..##.########.##..#...#
#...#..##....##....##..#...#
#......##....##....##......#
#.##########.##.##.##..###.#
#............##............#
#.##########.##.##########.#
#...########....########...#
#..........................#
############################
